P ####### 
#        #
#  #     #
#  Bb    #
#  TbB   #
#   TbB  #
#  TB b  #
#   T##  #
#        #
##########
1234567890